####################
#     c            #
#   _____          #
#            j     #
#        _____\    #
#_____             #
#         e        #
#       _____      #
#          w       #
#          _____   #
#                  #
#  _____           #
#                  #
#         _____    #
#P                 #
#_____             #
####################