#########################
#     c                 #
#   _____               #
#            j          #
#        _____          #
#_____                  #
#            p          #
# ______________________#
#########################