#########################
#     c                 #
#   _____               #
#            j          #
#        _____\         #
#_____                  #
#         e             #
#       _____           #
#          w            #
#          _____        #
#                       #
#  _____          _____ #
#                       #
#         _____         #
#            p          #
#          _____        #
#########################