####################
#                  #
#   ‾‾‾‾‾          #
#                  #
#        ‾‾‾‾‾\    #
#‾‾‾‾‾             #
#                  #
#       ‾‾‾‾‾      #
#                  #
#          ‾‾‾‾‾   #
#                  #
#  ‾‾‾‾‾           #
#                  #
#         ‾‾‾‾‾    #
#P                 #
#‾‾‾‾‾             #
####################