####################
#                  #
#   ‾‾‾‾‾          #
#            j     #
#        ‾‾‾‾‾\    #
#‾‾‾‾‾             #
#         e        #
#       ‾‾‾‾‾      #
#          w       #
#          ‾‾‾‾‾   #
#                  #
#  ‾‾‾‾‾           #
#                  #
#         ‾‾‾‾‾    #
#P                 #
#‾‾‾‾‾             #
####################